{
    "theme": "simple",
    "solution": [
        " . d . | d . . | . . . ",
        " . p . | . p . | d p . ",
        " . . . | . . . | . . . ",
        " ------+-------+------ ",
        " . . . | . . . | . . d ",
        " . p . | . p d | . p . ",
        " . . d | . . . | . . . ",
        " ------+-------+------ ",
        " . . . | . . . | . . . ",
        " d p . | . p . | . p . ",
        " . . . | d . . | . d . "
    ],
    "baddies": [
        " . . . | d . . | . . d ",
        " . p . | . p . | . p . ",
        " . . d | . . . | . . . "
    ]
}