{
    "theme": "simple",
    "solution": [
        " d . p | d . p | d . p ",
        " . . . | d . p | . . . ",
        " d . p | d . . | d . . ",
        " ------+-------+------ ",
        " d . . | . . p | . . . ",
        " d . p | d . p | d . p ",
        " . . p | . . p | d . p ",
        " ------+-------+------ ",
        " d . p | . . . | . . . ",
        " . . p | d . p | . . p ",
        " . . . | . . p | d . . "
    ],
    "baddies": [
        " . . p | . . p | d . p ",
        " . . . | . . p | . . . ",
        " d . p | d . . | . . p "
    ]
}