{
    "theme": "extradave",
    "solution": [
        " . v . | . . . | . . . ",
        " . . . | > . . | . m . ",
        " . . . | . . . | . . . ",
        " ------+-------+------ ",
        " . . . | . . . | . . . ",
        " . . < | . . . | m . . ",
        " . . . | ^ . . | . . . ",
        " ------+-------+------ ",
        " . . . | > . . | . . m ",
        " . . . | . . . | . . . ",
        " . . ^ | . . . | . . . "
    ],
    "baddies": [
        " . m . | . . . | . . . ",
        " . . . | m . . | . . . ",
        " . . . | . . . | . . m "
    ]
}