{
    "objects": {
        "x": { "class": "Human" },
        "y": { "class": "CoffeeMaker" }
    },
    "solution": [
        " x . . | . . . | . . x ",
        " . y . | . . y | . y . ",
        " . . . | . . x | . . . ",
        " ------+-------+------ ",
        " . . . | . . . | x . . ",
        " . . . | . y . | y . . ",
        " x y . | . . x | . . . ",
        " ------+-------+------ ",
        " . . . | . y x | x . . ",
        " . y . | . . . | . y . ",
        " x . . | . . . | . . . "
    ],
    "baddies": [
        " . . . | . . . | x y . ",
        " . . y | . y . | . . . ",
        " . . x | . . x | . . . "
    ]
}