{
    "objects": {
        "x": { "class": "Desk" },
        "y": { "class": "Server" }
    },
    "solution": [
        " . . . | x y . | . . . ",
        " . . y | . . . | . y . ",
        " . . x | . . . | . . x ",
        " ------+-------+------ ",
        " . . x | . . x | x . . ",
        " . y . | . y . | y . . ",
        " . . . | . . . | . . . ",
        " ------+-------+------ ",
        " . . . | . . . | . . . ",
        " y . . | . . . | . y . ",
        " x . . | x y . | x . . "
    ],
    "baddies": [
        " . y . | . . . | . y . ",
        " . . . | . y . | . x . ",
        " x . . | . . x | . . . "
    ]
}