{
    "objects": {
        "d": { "class": "Human" },
        "p": { "class": "Server", "args": { "color": "gray" } }
    },
    "solution": [
        " . d . | . . . | . . . ",
        " . p . | . p . | . p d ",
        " . . . | . . d | . . . ",
        " ------|-------|------ ",
        " . . . | . . d | . . d ",
        " d p . | . p . | . p . ",
        " . . . | . . . | . . . ",
        " ------|-------|------ ",
        " . . . | d . . | . d . ",
        " . p . | . p . | . p . ",
        " . d . | . . . | . . . "
    ],
    "baddies": [
        " . . . | d . . | . . . ",
        " . p . | . p . | d p . ",
        " . . d | . . . | . . . "
    ]
}