{
    "objects": {
        "a": { "class": "CoffeeMaker" },
        "b": { "class": "Plant" }
    },
    "solution": [
        " . . b | . . b | . . b ",
        " a . . | . a . | . . a ",
        " . . . | . . . | . . . ",
        " ------+-------+------ ",
        " b a . | b . . | b . . ",
        " . . . | . a . | . . . ",
        " . . . | . . . | . a . ",
        " ------+-------+------ ",
        " . . . | . . . | . . . ",
        " . . a | . a . | a . . ",
        " b . . | b . . | b . . "
    ],
    "baddies": [
        " . . a | . . . | . . . ",
        " . . . | . . a | . . . ",
        " b . . | b . . | b a . "
    ]
}