{
    "objects": {
        "a": { "class": "Plant" },
        "b": { "class": "Server", "args": { "color": "red" } }
    },
    "solution": [
        " b . . | b . . | b . a ",
        " . . . | . a . | . . . ",
        " a . . | . . . | . . . ",
        " ------+-------+------ ",
        " . . . | . . . | a . . ",
        " b . . | b a . | b . . ",
        " . . a | . . . | . . . ",
        " ------+-------+------ ",
        " a . . | . . . | . . . ",
        " . . . | . a . | . . . ",
        " b . . | b . . | b . a "
    ],
    "baddies": [
        " . . . | . . . | . . . ",
        " . . . | b . . | . . a ",
        " b a . | . . a | b . . "
    ]
}