{
    "objects": {
        "a": { "class": "Human" },
        "b": { "class": "CoffeeMaker" }
    },
    "solution": [
        " . . . | . . . | . . . ",
        " a b b | a . a | b a a ",
        " . . . | . . . | . . . ",
        " ------+-------+------ ",
        " . a . | . . . | . . . ",
        " . . b | . . . | . . a ",
        " . . . | . . b | . b a ",
        " ------+-------+------ ",
        " . a . | . . . | . . . ",
        " a b b | a . a | b a a ",
        " . . . | . . b | . b a "
    ],
    "baddies": [
        " . . . | . . . | . . . ",
        " . a a | . . a | b a . ",
        " . b a | . . . | . b a "
    ]
}