{
    "objects": {
        "a": { "class": "Plant" },
        "b": { "class": "Present" }
    },
    "solution": [
        " . a . | . a . | . . . ",
        " a . . | b . . | b . . ",
        " . . . | . . . | . a . ",
        " ------+-------+------ ",
        " . a . | . . . | a . . ",
        " . . b | b . . | b . . ",
        " . . . | . a . | . . . ",
        " ------+-------+------ ",
        " . a . | . a . | a . . ",
        " a . b | b . . | b . . ",
        " . . . | . a . | . a . "
    ],
    "baddies": [
        " a . . | a . . | . . . ",
        " a . . | . . . | a . b ",
        " . b . | . a . | . a . "
    ]
}