{
    "objects": {
        "a": { "class": "Desk" }
    },
    "solution": [
        " . a . | . . . | . a . ",
        " . a . | a a . | a . . ",
        " . . . | . . . | . . . ",
        " ------+-------+------ ",
        " . . a | . . a | . . . ",
        " a a . | a . . | . a . ",
        " . . . | . a . | . a . ",
        " ------+-------+------ ",
        " . . a | . . a | . . . ",
        " . . . | . . a | . . a ",
        " . . . | . . . | . . . "
    ],
    "baddies": [
        " . . a | . . a | . . . ",
        " . . . | . . a | . . a ",
        " . . . | . . . | . a . "
    ]
}