{
    "objects": {
        "a": { "class": "CoffeeMaker" },
        "b": { "class": "Plant" }
    },
    "solution": [
        " . . . | . b . | . b . ",
        " a . a | a . a | . . . ",
        " . b . | . . . | . b . ",
        " ------+-------+------ ",
        " . . a | . . . | . . a ",
        " . a . | . a . | . . . ",
        " . . . | a . . | a . . ",
        " ------+-------+------ ",
        " b . . | b . . | . . . ",
        " . a . | . . . | . a . ",
        " . . . | a . . | a . . "
    ],
    "baddies": [
        " b . . | b . . | . . a ",
        " . a . | . . . | . a . ",
        " a . . | . . . | . . . "
    ]
}