{
    "objects": {
        "d": { "class": "Plant" },
        "p": { "class": "Present", "args": { "color": "red" } }
    },
    "solution": [
        " d d p | . . . | . . . ",
        " . . p | . d p | . . p ",
        " . . . | . . p | . d d ",
        " ------|-------|------ ",
        " p . . | p p . | p . d ",
        " p . . | . d . | . . . ",
        " d . . | . . . | . . . ",
        " ------|-------|------ ",
        " . . . | . p . | d . . ",
        " p . p | d . d | . . . ",
        " . . d | . p . | . . . "
    ],
    "baddies": [
        " . . d | d . . | d p . ",
        " . . . | . p . | p . p ",
        " . . . | . . . | . p . "
    ]
}