{
    "objects": {
        ">": { "class": "DeskPc", "args": { "heading": "right" } },
        "m": { "class": "CupboardMachine" }
    },
    "solution": [
        " > m . | . . . | . . . ",
        " . . . | . . . | . . . ",
        " . . . | . . . | . . . ",
        " ------+-------+------ ",
        " . . . | . . . | . . . ",
        " . . . | . . . | . . . ",
        " . . . | . . . | . . . ",
        " ------+-------+------ ",
        " . . . | . . . | . . . ",
        " . . . | . . . | . . . ",
        " . . . | . . . | . . . "
    ],
    "baddies": [
        " . . . | . . . | . . . ",
        " . . . | . . . | . . . ",
        " . . . | . . . | . . . "
    ]
}